1111111
101E111
1001111
1P0C111
1111111