1111111
100E001
1000C01
1P0C001
1111111
