1111111
1E0P001
1000001
10C0001
1111111
