1111111
1E0P0C1
1000011
100C001
1111111
