1111111
1E0P001
1000011
1000001
1111111
