1111111
100P0C1
1000011
100C001
1111111
