1111111
1E0P0C1
1000011
1E0C001
1111111
