1111111
1E0P1C1
1000011
100C001
1111111
